Pedro Munhoz	L	KO/TKO	1
Cody Stamann	L	Decision - Split	3
Aljamain Sterling	W	Decision - Split	3
Eddie Wineland	W	Decision - Unanimous	3
Raphael Assuncao	L	Decision - Unanimous	3
Erik Perez	W	Submission	2
Johnny Bedford	W	Submission	3
Takeya Mizugaki	L	Decision - Split	3
Mitch Gagnon	W	Submission	3
Dustin Neace	W	Submission	2
Diego Brandao	L	KO/TKO	1
Marlin Weikel	W	Submission (Rear Naked Choke)	1
Fredson Paixao	L	Decision - Split	3
Mark Hominick	L	Submission	1
Eddie Pelczynski	W	Submission (Triangle Choke)	1
Alex Zuniga	W	Decision - Unanimous	3
Daniel Stenovich	W	Submission (Triangle Choke)	-
Wilson Reis	L	Unanimous Decision	3
Alvin Cacdac	W	Submission	1
Steve Sharp	W	Submission (Triangle Choke)	2
Dave Cochran	W	Submission (Rear Naked Choke)	2
Eddie Belen	W	TKO	1
Saul Mitchell	W	Submission (Armbar)	1
Harris Norwood	W	Submission (Rear Naked Choke)	2
Andy Lukesh	W	Submission (Rear Naked Choke)	2
John Gunderson	L	Submission (Armbar)	2
Trevor Harris	W	Submission (Rear Naked Choke)	1
Jason Chuckelnaskit	W	Submission (Rear Naked Choke)	2
Noah Thomas	W	Submission (Rear Naked Choke)	1
Galen Bush	W	TKO (Punches)	1
Ian Loveland	L	TKO	2
