Seo Hee Ham	L	Decision - Split	5
Suwanan Boonsorn	W	Submission	1
Jinh Yu Frey	W	Decision - Unanimous	3
Kanna Asakura	W	Submission (Armbar)	2
Mina Kurobe	W	Submission (Kimura)	1
Alyssa Garcia	W	Decision - Unanimous	3
Livinha Souza	L	TKO	1
Jinh Yu Frey	W	TKO (Doctor Stoppage)	2
Amber Brown	W	Submission (Armbar)	3
Herica Tiburcio	W	Decision - Split	5
Mei Yamaguchi	W	Decision - Unanimous	2
Naho Sugiyama	W	TKO	1
Claudia Gadelha	L	TKO (Punches)	3
Emi Fujino	W	Decision - Unanimous	3
Lacey Schuckman	W	Submission (Armbar)	3
Yuka Tsuji	W	Submission (Kimura)	1
Seo Hee Ham	W	TKO (Corner Stoppage)	1
Mizuki Inoue	W	Decision - Unanimous	2
Seo Hee Ham	W	Unanimous Decision	2
Sakura Nomura	W	Decision - Unanimous	2
Han Sol Lee	W	Submission (Keylock)	1
Kinuka Sasaki	W	Submission (Armbar)	2
