Patrick Cenoble	W
Renee Forte	L
Edson Barboza	L
Edward Faaloloto	W
Rafael Dos Anjos	L
Shannon Gugerty	W
Justin Buchholz	W
Brian Cobb	W
Sam Stout	W
Rich Clementi	L
Gleison Tibau	L
Matt Grice	W
Sami Berik	W
Edgars Podnieks	W
Greg Loughran	W
Danny van Bergen	W
Diego Gonzalez	W
Kamel Nacer	W
Aaron Blackwell	W
Neil Barber	W
Kris Leverton	W
