Michal Materla	L
Delson Heleno	W
Wes Swofford	W
Gary Padilla	W
Leonardo Nascimento Lucio	W
David Branch	L
Rousimar Palhares	L
Drew McFedries	W
Mike Ciesnolevicz	W
Ivan Serati	W
Thiago Silva	L
Andre Fyeet	W
Valdas Pocevicius	W
Lucio Linhares	W
Pavel Nohynek	W
Nordin Asrih	W
Denis Juskevic	W
Martin Kubes	W
Przemyslaw Tomczyk	W
Michael Knaap	W
Ulf Fritzmann	W
Jacek Buczko	W
Krzysztof Golaszewski	W
Slawomir Zakrzewski	W
Ulf Fritzmann	L
Daniel Les	W
Piotr Baginski	D
