Alessio Di Chirico	W	Decision - Unanimous	3
Omari Akhmedov	L	Decision - Unanimous	3
Trevin Giles	W	Submission	3
Trevor Smith	W	Decision - Unanimous	3
Michel Prazeres	L	Decision - Split	3
Nathan Coy	W	Submission	1
Alexander Yakovlev	W	Submission	2
Santiago Ponzinibbio	L	Decision - Unanimous	3
Nicolas Dalby	W	Decision - Unanimous	3
Dominique Steele	W	KO/TKO	1
Gunnar Nelson	L	Submission	2
Yan Cabral	W	Decision - Unanimous	3
Ben Alloway	W	Submission	1
Brandon Newsome	W	Submission (Guillotine)	1
Lamont Stafford	W	Submission (Rear Naked Choke)	1
Ryan Jimmo	L	Unanimous Decision	5
Jonathan Smith	W	TKO (Punches)	1
Dennis Reed	W	Submission (Armbar)	1
Rudy Bears	W	Submission (Brabo Choke)	1
Elvis Mutapcic	L	Unanimous Decision	5
Tim Kennedy	L	Submission	2
Dominic Brown	W	TKO (Punches)	1
Terry Martin	W	Decision - Split	3
Cole Jennet	W	Submission (Neck Crank)	1
Leo Pla	W	TKO (Punches)	2
Danny Anderson	W	Decision - Unanimous	3
Jason Broom	W	TKO (Punches)	2
Victor Moreno	W	Submission (Keylock)	2
James Bunch	W	Submission	2
Rudy Bears	W	Submission	3
Ron Jackson	W	Decision - Unanimous	3
