Satoshi Ishii	L	Submission (Kneebar)	1
Serghei Spivac	L	Submission (Neck Crank)	1
Cody East	L	Decision - Unanimous	3
Jordan Currie	W	Decision - Unanimous	5
Jason Walraven	W	TKO	1
Dan Charles	W	TKO	1
Tipo Lafaele	W	Decision - Unanimous	3
Mika Faavale	W	Submission (Rear Naked Choke)	4
Tomas Pakutinskas	W	Submission (Kimura)	1
Tracy Willis	W	Submission	1
Ronny Markes	L	Submission (Arm Triangle)	1
Myron Dennis	W	Decision - Unanimous	5
Andenilson Clementino	W	Submission (Kneebar)	4
Lamont Stafford	W	Submission (Choke)	2
Matt Howell	W	TKO	3
Jack May	L	Decision - Unanimous	3
Mike Hayes	W	Decision - Unanimous	5
Tanner Boser	L	Decision - Unanimous	5
Nathan Bryant	W	Decision - Split	5
Konstantin Gluhov	L	Decision - Unanimous	2
Shannon Ritch	W	Submission (Guillotine)	1
Egidijus Valavicius	W	Decision - Unanimous	5
Joe Yager	L	Decision - Unanimous	3
Tim Hague	W	TKO	3
Angel De Anda	L	Decision - Unanimous	3
Jared Torgeson	L	Decision - Split	3
Anthony McDonald	W	Submission (Rear Naked Choke)	2
Houston Alexander	W	TKO	3
Jamie Yager	L	Decision - Unanimous	3
Jeremy Horn	D	No Contest	5
Jesse Hernandez	W	Submission (Arm Triangle)	2
Cortrail Meadows	W	TKO	1
Wes Swofford	L	KO	1
Joe Doerksen	L	Unanimous Decision	3
Chase Gormley	L	TKO (Injury)	3
Tim Chemelli	W	TKO	1
Jared Cannonier	L	Decision - Split	5
Andenilson Clementino	W	Submission (Rear Naked Choke)	2
Trevor Prangley	L	Submission (Armbar)	2
Aleksei Oleinik	L	Submission (Triangle Choke)	3
Nick Rossborough	L	Decision - Unanimous	5
Trevor Prangley	L	Decision - Majority	4
Nick Rossborough	W	Decision - Split	3
Ilir Latifi	L	Unanimous Decision	3
Jason Walraven	W	KO/TKO	1
Cody East	W	KO/TKO	3
Rob Jackson	W	KO	2
Shamil Abdurakhimov	W	Submission (Triangle Choke)	3
Esteves Jones	W	KO/TKO	4
Dmitry Zabolotny	W	Submission (Armbar)	1
Esteves Jones	W	Submission (Rear Naked Choke)	4
Buddy Roberts	L	Decision - Unanimous	3
Ruben Villareal	W	Submission (Punches)	2
Jeff Monson	L	Unanimous Decision	5
Darrill Schoonover	W	Submission (Armbar)	3
Brian Ryan	W	Submission (Armbar)	1
Raphael Bergmann	W	KO/TKO	2
Brad Morris	W	Submission (Rear Naked Choke)	2
Raphael Davis	L	Unanimous Decision	3
Jason Lambert	W	KO	2
Mike Kyle	L	Split Decision	5
Tony Johnson Jr.	L	Decision - Unanimous	5
Tyler East	W	Submission (Triangle Choke)	1
Tyler East	W	Decision - Split	5
Joey Beltran	W	Unanimous Decision	5
Dave Cryer	W	Decision - Unanimous	5
Viktor Nemkov	W	Submission (Rear Naked Choke)	2
Chad Herrick	W	KO/TKO	5
Fernando Gonzalez	W	Submission (Rear Naked Choke)	5
Keith Berry	W	TKO	3
Fernando Gonzalez	W	Submission (Rear Naked Choke)	2
Wes Combs	W	Submission (Kimura)	2
Joey Beltran	W	Submission (Kimura)	1
Wade Hamilton	W	Submission (Punches)	1
Terroll Dees	W	KO/TKO	2
Liron Wilson	W	Submission (Rear Naked Choke)	1
John Brock	W	Submission (Rear Naked Choke)	3
Frank Appah	W	KO/TKO	1
Tony Bonello	L	Decision - Unanimous	2
Kyle Kingsbury	W	TKO	1
Josh Parisian	W	TKO	2
Justin Levens	L	Submission (Rear Naked Choke)	1
Tony Galindo	W	KO/TKO	1
