Roy Nelson	W	Decision - Unanimous	3
Javy Ayala	L	Submission (Punches)	2
Fedor Emelianenko	L	TKO	1
Mark Hunt	L	KO/TKO	1
Andrei Arlovski	L	Decision - Unanimous	3
Todd Duffee	W	KO/TKO	1
Antonio Silva	W	KO/TKO	1
Alistair Overeem	L	Decision - Unanimous	3
Josh Barnett	L	KO/TKO	1
Daniel Cormier	L	Decision - Unanimous	3
Junior Dos Santos	L	KO/TKO	2
Antonio Rodrigo Nogueira	W	Submission	1
Roy Nelson	W	Decision - Unanimous	3
Mirko Filipovic	W	KO/TKO	3
Shane Carwin	L	KO/TKO	1
Cheick Kongo	W	Submission	1
Brock Lesnar	L	KO/TKO	2
Antonio Rodrigo Nogueira	W	KO/TKO	2
Brock Lesnar	W	Submission	1
Antoni Hardonk	W	Submission	1
Brandon Vera	L	KO/TKO	1
Dan Christison	W	Decision - Unanimous	3
Marcio Cruz	L	KO/TKO	1
Tim Sylvia	W	Submission	1
Wes Sims	W	KO/TKO	2
Wes Sims	W	DQ	1
David Abbott	W	Submission	1
Ian Freeman	L	KO/TKO	1
Pete Williams	W	Submission	1
Roberto Traven	W	Submission	1
Dan Quinn	W	Submission (Triangle Choke)	1
Jerome Smith	W	Unanimous Decision	2
