Daiana Torquato	L	Decision - Split	1
Karina Rodriguez	L	Decision - Split	3
Christina Marks	W	KO/TKO	2
Vanessa Porto	L	TKO	3
Mara Romero Borella	L	Decision - Split	3
Marion Reneau	L	KO/TKO	3
Julianna Pena	L	KO/TKO	1
Elizabeth Phillips	W	Decision - Split	3
Daria Chibisova	W	Submission (Heel Hook)	1
Anastasia Plisenkova	W	Submission (Arm Triangle)	1
Pannie Kianzad	L	Decision - Unanimous	3
Jessica Andrade	L	Submission (Guillotine)	2
Danielle West	W	KO/TKO	1
Risalat Mingbatyrova	W	Submission (Arm Triangle)	1
Sheila Gaff	W	Decision - Unanimous	3
Ludmila Delicheban	W	KO/TKO	1
Victoria Syniavina	W	KO/TKO	1
Ekaterina Tarnavskaja	W	Submission (Slam)	1
Zeinab Gaurgashvily	W	Submission (Bulldog Choke)	1
Anna Smirnova	W	Submission (Straight Armbar)	1
Julia Berezikova	L	Submission (Punches)	1
