Marvin Vettori	L	Decision - Unanimous	3
Ian Heinisch	L	Decision - Unanimous	3
Karl Roberson	W	Submission	1
Nate Marquardt	W	Decision - Split	3
Elias Theodorou	L	Decision - Unanimous	3
Jack Hermansson	W	Submission	2
Anthony Smith	W	Decision - Unanimous	3
Oluwale Bamgbose	W	Decision - Unanimous	3
Jorge Masvidal	L	KO/TKO	1
Sam Alvey	L	KO/TKO	1
Andrew Craig	W	Decision - Unanimous	3
CB Dollaway	L	KO/TKO	1
Daniel Sarafian	W	Decision - Split	3
Thiago Santos	W	Submission	1
Sergio Moraes	W	Decision - Unanimous	3
Thiago Perpetuo	W	KO/TKO	1
Elvis Mutapcic	L	KO	1
Chaun Sims	W	KO	1
Cassiano Ricardo Castanho de Freitas	W	TKO (Doctor Stoppage)	2
Felipe Arinelli	W	Submission (Brabo Choke)	2
Andre Severo	W	TKO	1
Antonio Braga Neto	L	Decision	1
