Rick Hawn	L	Unanimous Decision	3
Justin Baesman	W	Submission (Armbar)	1
Marius Zaromskis	W	Unanimous Decision	3
Rick Hawn	L	Unanimous Decision	3
Thiago Michel	W	Decision - Split	3
JJ Ambrose	W	Submission	2
Chris Lozano	L	Unanimous Decision	3
Jay Hieron	L	Unanimous Decision	3
Dan Hornbuckle	W	Unanimous Decision	3
Jacob McClintock	W	TKO	1
John Troyer	W	Submission (Armbar)	1
Rudy Bears	W	KO	1
Akbarh Arreola	W	TKO	2
Robert Thompson	W	Submission (Rear Naked Choke)	1
John Mckean	W	TKO (Punches)	1
Tim Stout	W	TKO (Punches)	1
David Gaston	W	Submission (Rear Naked Choke)	2
Douglas Lima	W	Submission (Armbar)	2
Rhomez Brower	L	Split Decision	3
Matt Shaw	W	Submission (Punches)	1
Anthony Lapsley	L	TKO (Cut)	1
Jake Short	W	TKO (Corner Stoppage)	1
David Hulett	W	Submission	1
Chris Connelly	W	TKO (Punches)	1
Jake Short	L	Majority Decision	3
Hans Marrero	W	TKO (Punches)	1
Dan Hornbuckle	L	Submission (Triangle Choke)	2
Lucas Gwaltney	W	TKO (Corner Stoppage)	3
Gray Maynard	L	Unanimous Decision	3
Josh Cate	W	KO (Punch)	1
Anthony Stevens	W	Submission	-
Scott Henze	D	Draw	2
