Kalib Starnes	W	Decision - Unanimous	3
Gabriel Gonzaga	L	KO/TKO	1
Antonio Rodrigo Nogueira	L	Submission	2
Roy Nelson	L	KO/TKO	1
Stefan Struve	L	KO/TKO	2
John-Olav Einemo	W	KO/TKO	2
Yoshihiro Nakao	W	Unanimous Decision	3
Michal Kita	W	Submission (Omoplata)	1
Rameau Thierry Sokoudjou	L	DQ	2
Jim York	W	KO	1
Don Frye	W	TKO	1
Josh Barnes	W	TKO	1
Mu Bae Choi	L	TKO	2
Chris Guillen	W	TKO	-
Kerry Schall	W	TKO	1
Ron Waterman	W	KO/TKO	1
Mario Rinaldi	W	TKO	3
Justin Kahn	W	Submission (Rear Naked Choke)	1
Chuck Geyer	W	TKO	1
Terry Tucker	W	KO	1
Nick Walker	W	Submission (Punches)	1
Andre Mussi	W	TKO	1
James Samuels	W	KO	1
James Ferguson	W	KO	1
Seth Parker	W	Submission (Rear Naked Choke)	1
Greg Hammer	W	Submission (Punches)	1
Jeff Orieze	W	TKO	1
Mike Cooke	W	TKO	1
