Khaos Williams	L	KO/TKO	1
Max Griffin	W	Decision - Unanimous	3
Zak Ottow	W	KO/TKO	1
Song Kenan	W	Decision - Unanimous	3
Jordan Mein	L	Decision - Unanimous	3
Joshua Burkman	W	Submission	1
Keita Nakamura	L	Decision - Split	3
Niko Price	D	No Contest	2
James Moontasri	W	Decision - Unanimous	3
Kyle Noke	W	Decision - Split	3
Derrick Krantz	W	Submission (Guillotine)	1
Valdir Araujo	W	KO	3
Marcus Andrusia	W	TKO	1
Rashid Abdullah	W	Submission (Triangle Choke)	1
Larry Hopkins	W	TKO	1
Diego Henrique da Silva	L	TKO	1
Rashid Abdullah	W	DQ	3
Rob Wood	L	Split Decision	3
Brandon Farran	W	Submission (Armbar)	1
Rashon Lewis	W	TKO	1
Evert Gutierrez	W	Unanimous Decision	3
Jeff Rexroad	L	Decision - Split	3
Mark Garcia	W	Submission (Armbar)	1
Jose Castro	W	Submission (Armbar)	1
