Sigi Pesaleli	W
Brandon Halsey	L
Sean O'Connell	L
Dylan Potter	W
Smealinho Rama	W
Viktor Nemkov	L
Tony Lopez	W
Cassio Barbosa de Oliveira	L
Cully Butterfield	W
Thiago Santos	L
Yoel Romero	L
Andrew Craig	W
Aaron Simpson	W
Karlos Vemola	W
Paulo Filho	W
Diogo Osama	W
Wendres Carlos da Silva	W
Fernando Silva	W
Paulo Henrique Garcia Rodrigues	L
Fernando Almeida	W
Wanderlan Vila Cruzeiro	W
Roque Oliver	W
Charles Andrade	W
Michael Knapp	W
Junior Fofinho	W
Enrico Vaccaro	W
