Rory MacDonald	D	Decision - Majority (Draw)	5
Paul Daley	W	Decision - Unanimous	3
Brian Foster	W	Submission	2
Jake Shields	W	Decision - Unanimous	5
Joao Zeferino	W	Decision - Unanimous	5
Yushin Okami	W	Decision - Unanimous	3
Rousimar Palhares	L	Submission (Kneebar)	1
Dennis Hallman	W	Decision - Unanimous	3
Marcelo Alfaya	W	Decision - Split	3
Joshua Burkman	L	Submission (Guillotine)	1
Demian Maia	L	Decision - Unanimous	3
Erick Silva	W	Decision - Unanimous	3
Johny Hendricks	L	KO/TKO	1
BJ Penn	D	Draw	3
Thiago Alves	W	Decision - Unanimous	3
Ben Saunders	W	Decision - Unanimous	3
Mike Pierce	W	Decision - Unanimous	3
Paulo Thiago	W	Decision - Unanimous	3
Akihiro Gono	W	Decision - Unanimous	3
Georges St-Pierre	L	Decision - Unanimous	5
Chris Wilson	W	Decision - Unanimous	3
Diego Sanchez	W	Decision - Split	3
Roan Carneiro	W	Submission	2
Luigi Fioravanti	W	Submission	2
Kuniyoshi Hironaka	W	Decision - Unanimous	3
Thiago Alves	W	KO/TKO	2
Joshua Burkman	W	Submission	2
Brock Larson	W	Decision - Unanimous	3
Jeff Joslin	W	Decision - Split	3
Kengo Ura	W	Unanimous Decision	2
Shonie Carter	W	Submission (Slam)	3
Gabe Garcia	W	TKO	1
Kyle Jensen	W	Unanimous Decision	3
Solomon Hutcherson	D	No Contest	2
Wilson Gouveia	L	KO (Knee)	1
Eric Tix	W	KO	1
Dan Hart	W	Submission (Guillotine)	1
Felix Alvarez	W	KO	1
Mike Pyle	L	Submission (Rear Naked Choke)	1
