Hatsu Hioki	W
Alan Omer	L
Nazareno Malegarie	L
Daiki Hata	W
Daniel Romero	L
Georgi Karakhanyan	L
Takeshi Inoue	W
Kazuyuki Miyata	W
Robert Peralta	L
Bibiano Fernandes	W
Chase Beebe	W
Joachim Hansen	W
Michihiro Omigawa	L
Hideo Tokoro	W
Bibiano Fernandes	L
Yoshiro Maeda	W
Jong Won Kim	W
Cub Swanson	L
Leonard Garcia	L
Antonio Carvalho	W
Gesias Cavalcante	L
Gilbert Melendez	L
Hatsu Hioki	W
