Alejandro Perez	L	KO/TKO	2
Manvel Gamburyan	L	Decision - Unanimous	3
Wilson Reis	L	Submission	1
Danny Martinez	W	Decision - Unanimous	3
Jussier Formiga	L	Submission	1
Zach Makovsky	L	Decision - Unanimous	3
Urijah Faber	L	Submission	4
John Albert	W	Submission	1
Eddie Wineland	L	KO/TKO	2
Renan Barao	L	Decision - Unanimous	3
Jeff Curran	W	Decision - Unanimous	3
Ken Stone	W	KO/TKO	1
Dominick Cruz	L	Decision - Unanimous	5
Brad Pickett	W	Decision - Unanimous	3
Antonio Banuelos	W	Decision - Unanimous	3
Chad George	W	Submission	1
Takeya Mizugaki	W	Decision - Unanimous	3
Noah Thomas	W	KO/TKO	1
Antonio Banuelos	L	Decision - Split	3
Frank Gomez	W	Submission	1
Kenji Osawa	W	Decision - Unanimous	3
Damacio Page	L	Decision - Unanimous	3
Chris David	W	Unanimous Decision	3
Tyler Toner	W	Unanimous Decision	3
Joe Jesser	L	Submission (Armbar)	1
Louie Lagunsad	W	Submission (Heel Hook)	1
Mike Morris	W	Submission (Armbar)	1
