Ron Stallings	L	Decision - Unanimous	3
Arbi Agujev	L	Decision - Unanimous	3
Albert Tumenov	L	Decision - Unanimous	3
Beslan Isaev	L	Decision - Majority	3
Micah Terrill	W	TKO	1
Tim Williams	L	Decision - Unanimous	3
Dustin Long	W	TKO	1
Chris Curtis	W	Decision - Split	5
Ryan Dickson	W	TKO	2
Lyman Good	L	Submission (Rear Naked Choke)	1
Ryan Hodge	W	TKO	1
Michael Page	L	Decision - Unanimous	3
Andrey Koreshkov	L	KO	1
Jesus Martinez	W	Unanimous Decision	3
Mike Wade	D	No Contest	3
Stephen Thompson	L	Decision - Unanimous	3
Yuri Villefort	W	Decision - Unanimous	3
Chris Spang	L	KO/TKO	1
James Terry	W	Decision - Split	3
Lukasz Les	W	KO/TKO	2
Joe Ray	W	Decision - Unanimous	3
Daryl Harris	W	KO (Knee)	2
Craig Thieme	W	TKO	3
Robert Corpora	W	TKO	2
Chris Curtis	L	Decision - Unanimous	3
Juan Garcia	W	TKO	1
Brad Pole	W	TKO	1
