Jim Wallhead	L
	L
Eulogio Fernandez	W
Stefano Paterno	D
Bartlomiej Kurczewski	W
Angelo Rubino	W
Evasio D'Onofrio	W
Marvin Vettori	L
Gheorghe Gritko	W
Sergey Kostenko	W
Marvin Vettori	L
Teddy Surville-Perafide	W
Christophe Van Dijck	L
Andrea Fontana	W
Sergey Marinin	W
Adrian Croitoru	W
Mattia Geri	W
Alexandru Bejenaru	W
Alexej Savastenko	L
Andrea Mattu	W
Andrea Milano	W
