Cody Stamann	L	Decision - Unanimous	3
Hunter Azure	W	KO/TKO	2
Ode' Osbourne	W	Submission	1
Montel Jackson	L	Submission	1
John Lineker	L	KO/TKO	3
Renan Barao	W	Decision - Unanimous	3
Damian Stasiak	W	KO/TKO	3
Marlon Vera	L	Submission	1
Iuri Alcantara	W	Submission	1
Julio Arce	W	Submission (Guillotine)	3
Josh Robinson	W	KO (Spinning Back Fist)	3
Julio Arce	W	Decision - Majority	3
Jay Haas	W	Submission (Guillotine)	1
Andre Soukhamthath	W	Decision - Unanimous	3
Mark Cherico	W	Submission (Guillotine)	1
Andy Main	L	Submission (Triangle Choke)	1
Lester Caslow	W	Submission (Rear Naked Choke)	2
Jeff Smith	L	Submission (Armbar)	2
Scott Heckman	L	Decision - Unanimous	3
Jimmie Rivera	L	Decision - Unanimous	3
Tyler Kahihikolo	W	Decision - Unanimous	3
Bill Jones	W	KO	1
Ryan Vaccaro	W	TKO (Knee)	2
Raphael Chaves	W	TKO	2
Josh Parker	W	Submission (Rear Naked Choke)	1
Claudio Ledesma	L	Decision - Unanimous	3
Artur Rofi	L	Submission (Armbar)	1
Michael LaDuke	W	TKO (Doctor's Stoppage)	3
Manny Millan	W	Submission (Rear Naked Choke)	1
Siyam Yousefi	W	Submission (Guillotine)	1
Nate Ainsworth	W	KO	1
Dan Cion	L	Submission (Guillotine)	1
