Kenny Robertson	W
Lance Benoist	W
Jake Hecht	W
Dong Hyun Kim	L
Jake Ellenberger	L
Matthew Riddle	W
Ricky Goodall	W
Fabio Holanda	W
Jason Rorison	W
Iraj Hadin	W
Jacob MacDonald	W
Jesse Bongfeldt	L
Chester Post	W
Steve Vigneault	L
Mark Colangelo	W
John Alessio	L
Ali Nestor Charles	W
Chad W. Saunders	L
Steve Vigneault	W
Steve Vigneault	W
