Tony Lopez	L	Decision - Unanimous	5
Liam McGeary	L	TKO	1
Carlos Eduardo	W	Split Decision	3
Atanas Djambazov	W	TKO	1
Dan McGlasson	W	Unanimous Decision	3
Cully Butterfield	L	Decision - Unanimous	3
Eric Hammerich	W	Submission (Armbar)	1
Krzysztof Morzyszek	W	TKO	1
Hendrik Oschmann	W	TKO	1
Sergey Sokha	W	Submission (Toe Hold)	1
Gheorghe Drucioc	W	KO	2
Dmitriy Bulgak	W	KO	1
Malik Merad	L	TKO (Doctor Stoppage)	1
Sergey Sokha	W	TKO (Injury)	1
Attila Vegh	L	Unanimous Decision	2
Denis Bogdanov	W	Submission (Neck Crank)	1
Alexander Grebenkin	W	TKO (Doctor Stoppage)	1
Antoni Chmielewski	W	Unanimous Decision	3
Jean Pierre Waflard	W	KO	1
Matteo Minonzio	W	TKO	1
Jason Jones	W	Unanimous Decision	2
Dmitry Zabolotny	L	Submission (Armbar)	1
Oleksandr Tsuprikov	W	TKO	1
Juha Saarinen	W	TKO	1
Boris Jonstomp	W	Decision	2
Jair Goncalves	L	Submission (Rear Naked Choke)	1
Andre Fyeet	W	Submission (Triangle Choke)	1
Mikko Rupponen	L	TKO	1
Andre Fyeet	W	KO	1
Igor Kolacin	W	KO	1
Yasuhito Namekawa	L	Submission	1
Gela Getsadze	W	Submission (Guillotine)	1
Fedor Emelianenko	L	Submission (Kimura)	2
Krzysztof Gerke	W	TKO	1
Chris Haseman	L	Submission (Armbar)	1
Yasuhito Namekawa	W	Win	1
Andrei Kopylov	L	Decision	2
Achmed Sagidgusenov	W	Submission (Armbar)	1
Denis Baykov	W	TKO	1
