Shamil Zavurov	L	KO	1
Thawa Ril	L	KO	2
Joshua Thorpe	W	Submission (Rear Naked Choke)	1
Robert Washington	W	KO	2
Jorge Sarat	W	Submission (Armbar)	1
Moshe Kaitz	L	Unanimous Decision	3
Eric Wisely	L	Unanimous Decision	3
Eric Wisely	L	TKO	1
Tyson Griffin	L	KO/TKO	2
Marcus Aurelio	W	Decision - Unanimous	3
Frankie Edgar	L	Decision - Unanimous	3
Sean Sherk	L	Decision - Unanimous	5
Spencer Fisher	W	KO/TKO	2
Nate Diaz	W	Submission	2
Jamie Varner	W	Submission	3
Joe Jordan	W	Submission	3
Brandon Olsen	W	Submission (Armbar)	1
Toby Imada	W	Submission (Armbar)	1
Ryan Schultz	W	KO	1
Gabe Ruediger	W	KO	1
Kotetsu Boku	L	Majority Decision	2
Ray Cooper	L	KO	1
Yves Edwards	L	Split Decision	3
Manny Reyes Jr.	W	KO	1
Phil Johns	W	Submission (Rear Naked Choke)	1
Yves Edwards	L	Decision - Split	3
Josh Thomson	L	Decision - Majority	3
Caol Uno	W	KO/TKO	2
Richard Crunkilton	W	Decision - Unanimous	3
Ryan Diaz	W	Submission (Guillotine)	1
Anthony Hamlett	W	TKO	1
Yohei Suzuki	W	Submission (Guillotine)	1
Don Kaecher	W	Submission (Triangle Choke)	2
Mike Willus	W	Submission (Triangle Choke)	1
Mike Brown	W	Submission (Triangle Choke)	1
