Michael Chandler	L	KO	1
Myles Jury	W	Decision - Unanimous	3
Adam Piccolotti	W	Decision - Split	3
Saad Awad	W	Decision - Unanimous	3
Roger Huerta	W	Submission (Guillotine)	2
Patricky Freire	L	Decision - Split	3
Michael Chandler	L	Decision - Split	5
Patricio Freire	W	TKO (Injury)	2
Andrey Koreshkov	L	Decision - Unanimous	5
Jorge Masvidal	W	Decision - Split	5
Brandon Thatch	W	Submission	4
Donald Cerrone	L	Decision - Unanimous	3
Rafael Dos Anjos	L	KO/TKO	1
Rustam Khabilov	W	Submission	4
Josh Thomson	W	Decision - Split	5
Anthony Pettis	L	Submission	1
Gilbert Melendez	W	Decision - Split	5
Nate Diaz	W	Decision - Unanimous	5
Frankie Edgar	W	Decision - Split	5
Frankie Edgar	W	Decision - Unanimous	5
Clay Guida	W	Decision - Unanimous	3
Jim Miller	W	Decision - Unanimous	3
Mark Bocek	W	Decision - Unanimous	3
Anthony Pettis	L	Decision - Unanimous	5
Donald Cerrone	W	Submission	1
Jamie Varner	W	Submission	3
Donald Cerrone	W	Decision - Unanimous	5
Shane Roller	W	KO/TKO	1
Anthony Njokuani	W	Submission	2
Diego Saraiva	W	Unanimous Decision	3
Ricardo Tirloni	W	Submission (Guillotine)	2
Mike Maestas	W	Submission (Rear Naked Choke)	3
Bryan Corley	W	Submission (Rear Naked Choke)	1
David Dagloria	W	Submission (Punches)	1
Rocky Johnson	L	Submission (Anaconda Choke)	1
Allen Williams	W	TKO	1
Dan Gregary	W	Submission (Punches)	1
