Zhang Weili	L
Michelle Waterson	W
Valentina Shevchenko	L
Tecia Torres	W
Rose Namajunas	L
Rose Namajunas	L
Jessica Andrade	W
Karolina Kowalkiewicz	W
Claudia Gadelha	W
Valerie Letourneau	W
Jessica Penne	W
Carla Esparza	W
Claudia Gadelha	W
Juliana Lima	W
Rosi Sexton	W
Karla Benitez	W
Julia Berezikova	W
Kate Jackson	W
Liliya Kazak	W
Sylwia Juskiewicz	W
