Dustin Stoltzfus	L
Artem Frolov	L
Mick Stanton	W
Mattia Schiavolin	D
Aleksei Butorin	W
Grachik Bozinyan	W
Sergey Martynov	W
Charles Andrade	W
Joachim Christensen	L
Tassilo Lahr	W
Ali Arish	W
Antoni Chmielewski	L
Nikolai Alexiev	W
Cortez Coleman	W
Martin Zawada	W
Perry Filkins	L
Mike Seal	W
Herbert Goodman	L
Attila Vegh	L
Hans Stringer	W
Mathias Schuck	W
Benjamin Russ	W
Jochim Rijmen	W
Andre Walberer	W
Vincent Urbanczak	W
Franky Fanomez	W
Julian Ambosse	W
Niels Wienboeker	W
