Yoon Jun Lee	L	TKO (Injury)	1
Takeya Mizugaki	L	Decision - Unanimous	3
Rob Font	L	KO/TKO	1
Dustin Kimura	W	Decision - Unanimous	3
Francisco Rivera	L	KO/TKO	2
Brian Bowles	W	KO/TKO	2
Reuben Duran	W	Decision - Unanimous	3
Cub Swanson	L	KO/TKO	2
Hatsu Hioki	L	Decision - Split	3
Josh Grispi	W	KO/TKO	3
Mark Hominick	L	KO/TKO	1
Chan Sung Jung	W	KO/TKO	2
Leonard Garcia	D	Draw	3
Eddie Wineland	L	Decision - Unanimous	3
Matt Dell	W	Unanimous Decision	3
George Sotiropoulos	L	Submission	2
David Kaplan	W	Decision - Split	3
Shane Nelson	L	Decision - Split	3
Nick Buschman	W	TKO	1
Tito Jones	W	Unanimous Decision	3
Andrew Belvado	W	Submission (Rear Naked Choke)	1
Austin Pascucci	L	Submission (Armbar)	1
Ray Robinson	L	Submission (Armbar)	1
Matt Dell	W	Split Decision	3
Carlos Ortega	W	Unanimous Decision	3
Louie Rosa	W	Submission (Punches)	2
Nick Hedrick	L	Submission (Choke)	1
Jason Sterling	W	Submission (Choke)	1
Austin Pascucci	W	Submission (Armbar)	2
