Ali Bagov	L	KO/TKO	1
Islam Makoev	W	Decision - Unanimous	3
Alexandr Shabliy	L	KO	1
Munguntsooj Nandinerdene	L	KO	1
Hyung Seok Lee	W	Decision - Unanimous	3
Pablo Villaseca	W	TKO	1
Brent Primus	L	Decision - Split	3
John Teixeira	L	Decision - Split	3
Robert Washington	W	Split Decision	3
Alvin Robinson	W	TKO	2
Evandro Oliveira	W	Decision - Unanimous	3
Sergio Alvarez	W	Submission (Armbar)	1
Joao Luiz Nogueira	W	Decision - Unanimous	3
Bruno Machado	W	KO	1
Marcos Vinicius Costa Silva	W	KO (Punch)	1
Aldecley Barbosa Torres	W	Submission (Rear Naked Choke)	2
Mauricio Ariel Pare	W	Submission (Arm Triangle)	1
Carlo Prater	L	Submission (Arm Triangle)	2
Alexandre Guerra Lopes	W	TKO (Retirement)	2
Dimitry Burgo	W	Decision - Unanimous	3
Eduardo Jochuan	W	TKO	2
Igor Fernandes	W	Decision - Unanimous	3
Diego Braga Alves	W	Decision - Unanimous	3
Eduardo Melo	W	TKO	1
Rodrigo Almeida	W	Submission (Heel Hook)	1
Joao Paulo Rodrigues de Souza	L	Submission (Rear Naked Choke)	3
Rivanio Regiz	W	Decision - Unanimous	3
Antonio Lima	W	TKO	1
Rivanio Regiz	W	Decision - Unanimous	3
Patricio Freire	L	KO	1
Rivanio Regiz	L	Decision - Split	3
Luiz Carlos Gomes da Silva	W	Decision - Unanimous	3
Joao Paulo Rodrigues de Souza	W	Decision - Unanimous	3
Francisco Silva	W	Submission (Armbar)	2
Joao Paulo Rodrigues de Souza	W	Decision - Unanimous	3
Valderi Silva	W	Decision - Unanimous	3
Ricardo Eduardo Lins	W	KO (Head Kick)	1
Fabio Emanuel Rodrigues	W	TKO	2
Glauke Eugenio e Silva	W	TKO	2
Carlos Antonio	W	TKO	1
Edinaldo Edinaldo	W	TKO	1
Gleidson Alves Martins	W	Submission (Armbar)	3
Julio Cesar	W	Decision - Unanimous	3
