Andrew Kapel	W	Submission (Arm Triangle)	3
Costello Van Steenis	W	Decision - Unanimous	3
Chidi Njokuani	W	Submission (Rear Naked Choke)	1
Rafael Lovato Jr.	L	Submission (Rear Naked Choke)	3
Jason Radcliffe	W	Submission (Rear Naked Choke)	1
Kendall Grove	W	Technical Submission (Rear-Naked Choke)	1
Claudio Annichiarico	W	TKO	1
Brandon Halsey	W	Submission (Triangle Choke)	1
Dustin Jacoby	W	Submission (Rear Naked Choke)	2
Jaime Jara	W	Submission (Triangle Choke)	1
Fred Weaver	W	TKO	1
Reggie Pena	L	Submission (Guillotine)	2
Ryan Machan	W	Submission (Rear Naked Choke)	1
Kalib Starnes	W	TKO	2
Casey Huffman	W	KO/TKO	1
Dan Miller	L	Submission	2
Jason MacDonald	W	KO/TKO	1
Gerald Harris	L	KO/TKO	3
Jeremiah Riggs	W	TKO	1
James Hammortree	W	Submission	3
Roberto Traven	W	KO	1
Patrick Mandio	W	Submission (Armbar)	1
