Nik Lentz	L	KO/TKO	1
Takanori Gomi	L	KO/TKO	2
Bruno Carvalho	W	Decision - Unanimous	2
Bruno Carvalho	W	Decision - Unanimous	2
Jung Gyeong Lee	W	Submission (Punches)	1
Kazunori Yokota	L	Unanimous Decision	3
Clay French	W	Submission (Guillotine)	1
Sergey Golyaev	W	Submission (Armbar)	1
Satoru Kitaoka	L	Submission (Heel Hook)	1
Rodrigo Damm	W	Submission (Rear Naked Choke)	1
Kwang Hee Lee	W	Submission (Rear Naked Choke)	1
Joachim Hansen	W	Majority Decision	3
Kotetsu Boku	L	Split Decision	3
Takumi Nakayama	W	TKO (Punches)	1
Brian Cobb	W	Submission (Guillotine)	3
Danilo Cardoso Sanolini	W	Submission (Armbar)	1
Paul Rodriguez	W	Submission (Guillotine)	2
Vitor Ribeiro	L	Unanimous Decision	3
Samy Schiavo	W	Submission (Rear Naked Choke)	1
Nick Agallar	L	Unanimous Decision	3
Shigetoshi Iwase	W	TKO (Punches)	1
Kyosuke Sasaki	D	Draw	2
Chris Brennan	L	Submission	1
Gleison Tibau	W	TKO (Corner Stoppage)	2
Zuli Silawanto	W	Submission (Rear Naked Choke)	1
Scott Bills	W	Unanimous Decision	2
John Alessio	L	TKO (Cut)	2
Anthony Macias	W	Unanimous Decision	3
Betiss Mansouri	D	Draw	3
Gerald Strebendt	W	Submission (Strikes)	1
