Ricardo Tirloni	L	Unanimous Decision	3
Marcin Held	L	Submission (Toe Hold)	2
Alexander Sarnavskiy	W	Decision - Split	3
Robert Washington	W	Submission (Guillotine)	3
Derek Campos	W	Submission (Guillotine)	1
Chris Clements	L	TKO	3
Ronnie Rogers	W	Submission (Rear Naked Choke)	2
Shinya Aoki	L	Submission	2
Reza Madadi	L	Unanimous Decision	3
Josh Hinkle	W	Unanimous Decision	3
Aaron Derrow	L	Submission (Triangle Choke)	3
Felipe Enomoto	W	Submission (Armbar)	3
Carey Vanier	L	Split Decision	3
Lenny Nelson	W	Submission (Rear Naked Choke)	1
Glen Cordoza	W		-
Quinn Mulhern	L	TKO	2
Mike Budnik	W	Submission (Rear Naked Choke)	5
Derrick Krantz	W	Submission (Armbar)	1
Chris Stringer	W	Submission (Triangle Choke)	2
Kyle Jensen	L	TKO (Injury)	1
Omar Zapata	W	Submission (Arm Triangle)	1
Gleison Tibau	L	Submission	1
Gray Maynard	L	Decision - Unanimous	3
Terry Etim	W	Decision - Unanimous	3
Sam Stout	W	Decision - Split	3
Melvin Guillard	W	Submission	1
Antoine Skinner	W	Submission (Strikes)	1
Anthony Johnson	W	Submission	2
Kyle Gibbons	W	Submission (Rear Naked Choke)	1
Roan Carneiro	L	Decision - Unanimous	3
Ross Pointon	W	Submission	2
Din Thomas	L	Submission	2
Caol Uno	L	Unanimous Decision	2
Brian Dunn	W	TKO	1
Fabio Holanda	W	TKO	3
Ryan Schultz	W	Submission (Armbar)	1
Chris Mickle	W	TKO	1
Daisuke Hanazawa	W	Unanimous Decision	3
Henry Matamoros	W	Unanimous Decision	3
Tom Kirk	W	Submission (Rear Naked Choke)	1
Eddie Yagin	W	TKO (Doctor Stoppage)	3
Sergey Golyaev	W	Submission (Triangle Choke)	2
David Gardner	L	Unanimous Decision	3
Tomomi Iwama	W	Unanimous Decision	2
Naoyuki Kotani	W	Unanimous Decision	2
Marcus Aurelio	L	Submission (Injury)	1
Alosio Barros	W	Unanimous Decision	2
Hiroki Kotani	D	Draw	3
Jon Weidler	W	KO	1
Yves Edwards	L	Submission	3
James Meals	W	TKO	1
Isaias Martinez	W	TKO	1
Joe Jordan	W	Submission (Armbar)	1
Justin James	W	Submission (Rear Naked Choke)	2
Cedric Stewart	W	Submission (Rear Naked Choke)	1
Warren Donley	W	KO	2
Danny Payne	W	Submission (Neck Crank)	1
Edwin Allseitz	W	Submission (Kimura)	1
Jeremy Jiminez	W	Submission (Armbar)	1
Pete Spratt	L	TKO (Doctor Stoppage)	1
Charles Bennett	W	Submission (Strikes)	1
Steve Berger	L	Submission (Armbar)	1
Rick McCoy	L	Decision	2
Ben Earwood	L	Submission (Armbar)	1
Dymitrius Wilson	W	TKO	1
Aristides Britto	W	Submission (Strikes)	1
Scott Melia	W	Submission (Strikes)	1
Rick Thompson	L	Decision	1
Chris Seifert	L	Unanimous Decision	3
