Manny Reyes Jr.	W	Submission (Rear Naked Choke)	1
Eban Oroz	W	TKO	1
Yves Edwards	W	Unanimous Decision	3
Jason Bryant	W	TKO	1
Rocky Long	W	Submission (Rear Naked Choke)	2
Dustin Neace	W	Submission (Guillotine)	1
Masakazu Imanari	L	Submission (Kneelock)	2
Takeshi Yamazaki	W	Unanimous Decision	3
Taiyo Nakahara	W	Submission (Arm Triangle)	2
Renato Tavares	W	Unanimous Decision	3
Joe Lauzon	L	Submission (Rear Naked Choke)	3
Leigh Remedios	W	Unanimous Decision	3
Renat Myzabekov	W	Submission (Heel Hook)	1
Mark Hominick	W	Submission (Heel Hook)	3
Shawn Graham	W	TKO	2
Mike Large	W	Submission (Rear Naked Choke)	1
Bill Mahoney	W	Submission (Rear Naked Choke)	3
Edward Odquina	W	Submission (Rear Naked Choke)	1
Hermes Franca	L	Submission (Triangle Choke)	1
Vinny Brightman	W	Submission (Rear Naked Choke)	1
Jeff Darienzo	W	Submission (Keylock)	1
