Omari Akhmedov	W
Dominick Reyes	L
Jacare Souza	L
Kelvin Gastelum	W
Gegard Mousasi	L
Yoel Romero	L
Luke Rockhold	L
Vitor Belfort	W
Lyoto Machida	W
Anderson Silva	W
Anderson Silva	W
Mark Munoz	W
Demian Maia	W
Tom Lawlor	W
Jesse Bongfeldt	W
Alessio Sakara	W
Valdir Araujo	W
Uriah Hall	W
Mike Stewart	W
Reubem Lopes	W
