Jussier Formiga	W
Jordan Espinosa	W
Mark De La Rosa	W
Joseph Benavidez	L
Jose Torres	W
Eric Shelton	W
Carls John de Tomas	W
Kevin Gray	W
Tyler Bialecki	W
Andrew Natividad	W
Ralph Acosta	W
Ray Elizalde	W
Jared Papazian	L
Adam Antolin	L
Martin Sandoval	W
Anthony Figueroa	W
Del Hawkins	W
Eloy Garza	W
Jeff Carson	W
Peter Baltimore	W
Carlos DeSoto	W
Javier Galas	W
Edgar Diaz	W
Kevin Michel	W
John MaCalolooy	L
Edgar Diaz	L
Sam Stevens-Milo	W
Ruben Trujillo	W
Jesus Castro	W
