Tyron Woodley	W
Demian Maia	W
Gunnar Nelson	W
Aleksei Kunchenko	W
Mike Davis	W
Olivier Aubin-Mercier	W
Dan Hooker	L
Dan Moret	W
Jason Saggo	W
Michel Prazeres	L
Lukasz Sajewski	W
Rashid Magomedov	L
Alex Oliveira	W
Christos Giagos	W
Andreas Stahl	W
Paulo Teixeira	W
Paulo Goncalves Silva	W
Rodolfo Rodrigues	W
Paulo Roberto	W
Vinicius Alves Bohrer	W
Herles dos Santos	W
Jose Salgado	W
