Luiz Gustavo	L
Yves Landu	W
Salimkhan Sadulloev	W
Kenichiro Togashi	W
Takahiro Ashida	L
Shigetoshi Iwase	W
Koichi Ishizuka	W
Guy Delumeau	W
Young Ki Hong	W
Tatsunao Nagakura	L
Juri Ohara	W
Jin Soo Son	W
Kenjiro Takahashi	L
Mitsuhiro Okada	W
Yusuke Sanders Jr.	W
Hiroyuki Nozawa	W
Kazushi Tsukagoshi	W
Hiroki Kishino	W
Isao Sakiyama	W
Tomoharu Toda	W
Hidenobu Koike	W
Yoshiki Nakahara	L
Ryan Dunstan	L
Yusuke Kanaeda	W
Koichiro Takekawa	L
Valerio Galosi	L
