Brandon MacArthur	W
Chris Weidman	L
Rafael Natal	D
Nolan Clark	W
Chris Fontaine	W
Dan Shenk	W
TJ Grant	W
Chris Clements	W
Sean Pierson	W
Sean Huffman	W
Jonathan Goulet	L
Elmer Waterhen	W
Jason St. Louis	W
Eric Beaulieu	W
Jan Kaszuba	W
Keith Sogla	W
Garrett Davis	L
Paulo Albuquerque	W
Garrett Davis	W
Jamie Varner	L
Quenton Pongracz	L
Chris McKinnon	W
