Rose Namajunas	L
Zhang Weili	L
Rose Namajunas	W
Karolina Kowalkiewicz	W
Tecia Torres	W
Claudia Gadelha	W
Joanna Jedrzejczyk	L
Angela Hill	W
Joanne Calderwood	W
Jessica Penne	W
Raquel Pennington	L
Sarah Moras	W
Marion Reneau	L
Larissa Pacheco	W
Raquel Pennington	W
Rosi Sexton	W
Liz Carmouche	L
Milana Dudieva	W
Luciana dos Passos Pereira	W
Jennifer Maia	L
Vanessa Silva	W
Alessandra Silva	W
Duda Yankovich	W
Juliana Silva	W
Lilian Correia	W
Kinberly Tanaka Novaes	L
Bruna Fernandes	W
Weidy Borges	W
