John Makdessi	L
Sako Chivitchian	W
Jonathan Brookins	L
Steve Reyna	W
Josh Bernal	W
Decarlo Johnson	W
Kevin English	W
Tyler Jackson	L
Dan Spychalski	W
Chris Higi	W
Sherron Leggett	L
Cory Conger	W
Bart Palaszewski	L
Joe Voisin	W
Chris Higi	W
Spencer Fisher	L
Jason Bryar	W
John Paun	L
Thomas Cubas	W
Henry Matamoros	L
Tom Kirk	L
Monte Skinner	W
