James Mulheron	L
Shamil Abdurakhimov	L
Tomasz Czerwinski	W
Todd Duffee	L
Thiago Santos	L
Mike Hayes	L
Zak Jensen	W
Cole Konrad	L
Aleksei Oleinik	W
Eddie Sanchez	W
Stav Economou	D
Martin Thompson	W
Mike Ciesnolevicz	L
James McSweeney	W
Robert Berry	W
Rob Broughton	L
Robert Berry	W
Domagoj Ostojic	W
James Thompson	W
Denniston Sutherland	W
Anthony Okorie	W
