Georgi Karakhanyan	L
Charlie Leary	W
Gracjan Szadzinski	L
Sergio de Jesus Santos	W
Lukasz Chlewicki	W
Rob Sinclair	W
Norman Parke	L
Chris Stringer	W
Robert Whiteford	L
Mirsad Bektic	L
Alexis Savvidis	W
Damien Brown	W
Mateusz Teodorczuk	L
Marc Allen	W
Alexei Roberts	W
Ryan Roddy	W
Lewis Long	W
Yuri Malko	W
Kuat Khamitov	L
Philip Mulpeter	W
Ian Williams	W
Jonathan Faivre	W
Richard McLarty	L
