Vicente Luque	W
Anthony Pettis	L
Darren Till	L
Jorge Masvidal	W
Tyron Woodley	L
Tyron Woodley	D
Rory MacDonald	W
Johny Hendricks	W
Jake Ellenberger	W
Patrick Cote	W
Robert Whittaker	W
Chris Clements	W
Nah-Shon Burrell	W
Matt Brown	L
Dan Stittgen	W
Patrick Mandio	W
William Kuhn	W
Marques Worrell	W
Daniel Finz	W
Jeremy Joles	W
