Daniel Cormier	W
Daniel Cormier	W
Daniel Cormier	L
Francis Ngannou	W
Junior Dos Santos	W
Alistair Overeem	W
Fabricio Werdum	W
Andrei Arlovski	W
Mark Hunt	W
Junior Dos Santos	L
Fabio Maldonado	W
Gabriel Gonzaga	W
Roy Nelson	W
Stefan Struve	L
Shane Del Rosario	W
Phil de Fries	W
Joey Beltran	W
Bobby Brents	W
William Penn	W
Gregory Maynard	W
Jeremy Holm	W
Paul Barry	W
Corey Mullis	W
