Jerome Jones	W	Unanimous Decision	3
Fraser Opie	L	DQ	2
Matt Ewin	L	Unanimous Decision	3
Rousimar Palhares	L	Submission	1
Terry Martin	L	KO/TKO	1
Art Santore	W	KO/TKO	2
Nate Marquardt	L	Decision - Unanimous	3
Joe Riggs	W	Submission	1
Tony Fryklund	W	Submission	1
Khaliun Boldbataar	W	Unanimous Decision	2
Rene Rooze	L	TKO (Injury)	1
Matt Lindland	L	Decision - Unanimous	3
Andrei Semenov	W	KO/TKO	3
John Renken	W	TKO	1
Jason Rigsby	W	Decision	2
Steve Heath	W	TKO (Cut)	1
Dan Corpstein	W	KO	2
Akihiro Gono	L	KO	1
Dan Corpstein	W	Submission (Rear Naked Choke)	2
Andy Ryan	L	KO	-
Jason Darrah	W	Submission (Armbar)	2
Auggie Padeken	W	Unanimous Decision	2
Peter da Silva	W	Submission	-
