Evan Dunham	L	Decision - Unanimous	3
Al Iaquinta	L	KO/TKO	3
Rashid Magomedov	L	Decision - Unanimous	3
Ivan Jorge	W	Decision - Unanimous	3
Mizuto Hirota	W	Decision - Split	3
Antonio Carvalho	L	Decision - Split	3
Anistavio Medeiros	W	Submission	1
Justin Wilcox	L	TKO - Doctor's Stoppage	1
Maximo Blanco	L	TKO	2
Ivan Iberico	W	Unanimous Decision	3
Gilbert Melendez	L	KO/TKO	2
Eiji Mitsuoka	L	Submission (Rear Naked Choke)	1
Jorge Masvidal	W	TKO	2
Johil de Oliveira	W	Decision	3
Ryan Bow	W	KO	2
Santino Defranco	W	Submission (Rear Naked Choke)	3
Kultar Gill	W	Submission (Rear Naked Choke)	2
Naoki Seki	W	Submission (Armbar)	1
Jyu Do Fan	W	Submission (Rear Naked Choke)	1
Luciano Silva	W	Submission (Rear Naked Choke)	1
Luciano Azevedo	L	Decision - Split	2
