Gilbert Burns	L	Decision - Unanimous	3
Leon Edwards	L	Decision - Split	3
Alex Oliveira	W	Submission	2
Santiago Ponzinibbio	L	KO/TKO	1
Alan Jouban	W	Submission	2
Albert Tumenov	W	Submission	2
Demian Maia	L	Decision - Unanimous	3
Brandon Thatch	W	Submission	1
Rick Story	L	Decision - Split	5
Zak Cummings	W	Submission	2
Omari Akhmedov	W	Submission	1
Jorge Santiago	W	Decision - Unanimous	3
DaMarques Johnson	W	Submission	1
Alexander Butenko	W	Submission (Armbar)	1
Eugene Fadiora	W	Submission (Rear Naked Choke)	1
Danny Mitchell	W	Submission (Rear Naked Choke)	1
Sam Elsdon	W	Submission (Rear Naked Choke)	1
Iran Mascarenhas	W	KO	2
Barry Mairs	W	TKO	1
Niek Tromp	W	TKO	1
Adam Slawinski	W	TKO	1
Driss El Bakara	W	Submission (Armbar)	1
John Olesen	D	Decision - Split (Draw)	3
