Dan Ige	L	KO/TKO	1
Mads Burnell	L	Decision - Unanimous	3
Zabit Magomedsharipov	L	Submission	2
Mark Cherico	W	KO/TKO	1
Nick Wayne	W	TKO	1
Luis Saldana	W	TKO	3
Lester Caslow	W	Submission (Rear Naked Choke)	1
Joe Pacheco	W	Submission (Arm Triangle)	1
Mervin Rodriguez	W	Decision - Unanimous	3
Shelby Graham	W	Submission (Armbar)	1
Kenny Foster	W	Submission (Guillotine)	1
Gustavo Rodriguez	W	Submission (Guillotine)	1
Frankie Perez	L	Submission (Rear Naked Choke)	1
Mike Medrano	L	Submission (Guillotine)	1
Phillipe Nover	L	Decision - Unanimous	3
Terry House Jr.	W	Submission (Rear Naked Choke)	2
Dustin Phillips	W	Submission (Rear Naked Choke)	1
Deividas Taurosevicius	L	Submission (Armbar)	2
Omar Vega	W	TKO	1
Taurean Bogguess	L	Submission (Guillotine)	1
Andrew Osborne	W	KO/TKO	1
Josh Shockley	L	Submission (Rear Naked Choke)	1
Brendan Weafer	L	Submission (Triangle Choke)	1
Zach Underwood	W	Decision - Unanimous	3
Eric Kriegermeier	L	Submission (Rear Naked Choke)	2
Jeff Green	W	Submission (Rear Naked Choke)	1
Ramon Barber	W	KO/TKO	1
Donavon Winters	L	KO/TKO	2
Jake Murphy	W	Decision - Split	3
Brian van Hoven	W	Decision - Unanimous	3
