Chris Honeycutt	L	Decision - Unanimous	3
AJ Matthews	W	Decision - Unanimous	3
Francisco France	L	Submission (Rear Naked Choke)	2
Benji Radach	W	Decision - Unanimous	3
Shamir Garcia	W	Decision - Unanimous	3
Danilo Pereira	W	Decision - Unanimous	3
Adam Rodriguez	W	TKO	1
Amilcar Alves	W	Decision - Unanimous	3
Fabio Marongiu	W	TKO - Doctor's Stoppage	2
Marcos Rogerio de Lima	D	Draw	3
Aldo Silva	W	Decision - Unanimous	3
Raimundo Moreno Lima Jr.	W	Submission (Keylock)	1
Fernando di Pierro	W	Decision - Unanimous	3
Tyson Triplett	W	TKO	1
Joao Paulo Pereira	W	TKO	1
Daniel Aspe	W	Submission (Rear Naked Choke)	1
Vinicius Carvalho	W	TKO	1
Fernando Roca Duany	W	TKO	1
Fernando di Pierro	W	Decision - Unanimous	3
Fernando Roca Duany	W	TKO	2
