Jordan Griffin	W	Decision - Unanimous	3
Bobby Moffett	L	No Contest	2
Jason Knight	L	KO/TKO	3
Chris Gruetzemacher	W	Submission	2
Maximo Blanco	W	Submission	1
Darren Elkins	L	Decision - Unanimous	3
Edimilson Souza	W	Submission	2
Jim Alers	W	KO/TKO	2
Sean Soriano	W	Decision - Unanimous	3
Tom Niinimaki	W	Submission	1
Mirsad Bektic	L	Decision - Majority	3
Jarrod Card	W	Unanimous Decision	3
Rey Trujillo	W	KO/TKO	3
Luis Vega	W	Unanimous Decision	3
Jeremy Myers	W	Submission (Brabo Choke)	1
Daniel Pineda	W	Submission (Kneebar)	2
Tim Snyder	W	Submission (Rear Naked Choke)	2
Daniel Pineda	W	Submission	1
Jimmy Guzman	W	Submission	2
Mike Braswell	W	Split Decision	3
Joshua Gerber	W	TKO	1
Will Samuels	W	Submission	1
